11111111111111111111111111111
1E0000000000000C00000C0001001
11001111001000001010010000001
1P110000101010100010010001001
10100100101C1010S010010001101
101001S0101110100010010001C01
10100100101010100010010S01101
10100010101010100010010001101
100001000C00C00000000000000C1
11111111111111111111111111111
