111111111111
1S000P000C11
100C00001111
100E00000111
10C000000011
10000S00S011
1C0000000011
111111111111