111111111111111111111111
1E0000000000000C0S000C01
101001010010000010100C01
101001S01010101000100101
1P0000000C00C0000S000001
111111111111111111111111
